||||||||||
|O..P.B.L|
|...PPPPP|
|.LL.....|
|PPP.R.|D5|
|.ZPPPP|.|
|L.W15...|E|
||||||||||
