|||||||||||||
|O..W15W16PPPPPL
|R..Z....P..L
|........P..L
|.Z..D6D5|.P..L
|...PLLLP...L
|J...PPP...E|
|||||||||||||
