||||||||||
|O......L|
|...W15...L|
|.......L|
||||D5|||||
|L...PP.L|
|.Z.LL.RE|
||||||||||
