||||||||||
|O.PP.Z.S|
|..|||||||
|.......S|
|SSSS....|
|...PPPPP|
|.R.....E|
|||||SSS||
