||||||||||
|O......S|
|...W15...S|
|.......S|
||||D5|||||
|S...PP.S|
|.Z.SS..E|
||||||||||
