|||||||||||||
|O..W15W14PPPPP.L
|R..Z....P..L
|........P..L
|.Z..D4D5|.P..L
|...PLLLP...L
|J...PPP...E|
|||||||||||||
