||||||||||
|O..P.B.L|
|...PPPPP|
|.LL.....|
|PPP.R.|D5|
|..PPPP|.|
|L.W15...|E|
||||||||||
