|||||||||||||
|SS...E...SS|
|.....PZ....|
|.....ZP....|
|PP...P...PP|
|..PZPZ..P..|
|J.PP.P.PP.O|
|SS|||||||SS|
