||||||||||
|O..P.B.L|
|J..PPPPP|
|.LL.....|
|PPP.R.|D5|
|.ZPPPP|.|
|L.W15...|E|
||||||||||
