||||||||||
|OSP.P..S|
|..P.S.PS|
|PPPP...P|
|B.....|D5|
|S.....|R|
|W15ZSSS.|E|
||||||||||
