|||||||||||||
|RPPL.P.Z...|
|.PPL.P....L|
|ZPPE.P|D5||||
|JPPPPP....L|
|.PPPPP.....|
|L...W15...O..|
|||||||||||||
