||||||||||
|OLP.P..L|
|J.P.L.PL|
|PPPP...P|
|B.....|D5|
|L.....|R|
|W15ZLLL.|E|
||||||||||
