|||||||||||||
|RPPS.P.Z...|
|.PPS.P.....|
|ZPPE.P|D5||||
|JPPPPP....S|
|.PPPPP.....|
|S...W15...O..|
|||||||||||||
