|||||||||||||
|J.P..S|PZ.S|
|O.P.RS|B...|
|PPS...S|||D5|
|...........|
|S||........|
|E.D6.W16.....W15|
|||||||||||||
