||||||||||
|OSP.P..S|
|..P.S.PS|
|PPPP...P|
|......|D5|
|S.....|R|
|W15..S..|E|
||||||||||
