|||||||||||||
|J.P..L|PZ.L|
|O.P.RL|B...|
|PPL...L|||D5|
|...........|
|L||........|
|E.D6.W16.....W15|
|||||||||||||
