||||||||||
|O...Z...|
|J.......|
|.Z......|
|...PPPPP|
|...P....|
|...P.R.E|
||||||||||
