|||||||||||||
|LL...E...LL|
|R....PZ....|
|.....ZP....|
|PP...P...PP|
|..PZPZ..P..|
|J.PP.P.PP.O|
|LL|||||||LL|
