||||||||||
|O.PP.Z.L|
|J.|||||||
|.......L|
|LLLL....|
|...PPPPP|
|.R.....E|
|||||LLL||
