|||||||||||||
LJ.P..L|PZ.L|
LO.P.RL|B...|
|PPL...L|||D5|
|...........|
|L||........|
|E.D4.W14.....W15|
|||||||||||||
