|||||||||||||
|O..W15W16PPPPPS
|R..Z....P..S
|........P..S
|.Z..D6D5|.P..S
|...PSSSP...S
|J...PPP...E|
|||||||||||||
