||||||||||
|O..P.B.S|
|...PPPPP|
|.SS.....|
|PPP.R.|D5|
|..PPPP|.|
|S.W15...|E|
||||||||||
